S...PPIP..###############....#
##.######.##############.P##.#
##P######...P.........##.###.#
##.#######.#######.#####.###.#
##P..I####.#######.#####.###.#
#..####......PIP...#####.###.#
#.#####.################.###.#
#P#####..................###.#
#P##########################.#
#..PIP..PIP..............PIP.#
############################A#
############################G#